11111111111111111
10011001010000001
10E0101101010PC01
11C0001C00001C011
10001001000000001
100100C0111010001
10C000CC100010001
10C000000010111C1
1C01100C00010C00111111111111111111
10011001010000001
10E0101101010PC01
11C0001C00001C011
10001001000000001
100100C0111010001
10C000CC100010001
10C000000010111C1
1C01100C00010C001
11111111111111111
11000000100010101
1C000000100000001
111CP101000000011
111100C000100C101
11CC10101C0110101
110000100000CC001
10111100000000011
110011001000011E1
1111111111111111111111111111111111
11000000000001001
101C0CC1101111001
10C00001000011011
101010110E01000C1
1000000CC00110001
11011100100010001
1C011C01000110P11
110000000110C1101
1111111111111111111111111111111111
1C10C100000C01C11
1111000CC100C0001
1111E000000000001
10100C000000001C1
1001C0C0000000001
10100010001C01001
101011001P0100011
100C1001CC011C001
1111111111111111111111111111111111
1100000101C0C1001
10C10C00110000011
1C001000110010111
10C111001101001C1
10C1000000010C001
1101P000E00000011
10001110C11111001
11101110000010011
11111111111111111