11111111111111111
111000001C000C111
110P1100010010111
11C10100100100011
100CC0101001E0101
111100C100C100111
1000000C010001001
10010100100111C01
100011C1111001C11
11111111111111111
11111111111111111
11100000101110001
10011100CP0010001
1000010CE100C00C1
100C00011C0110011
1000C000C00000011
1C00100C010011011
110C0010100C00001
100010C011010C011
11111111111111111
