111111111111111111111111111111
1000C100010010C0000C1C110C0C01
100C101010010C0100100101101101
10100001C000C0CC001010P10100C1
101010C11010101010011000000001
10C000001C0C100100011001001101
1000000001000C01110101C000C101
11100000101011001C0010000000C1
11C0010010001110001111110C1001
10100C010011000000001C101C0101
1001010000C1000000100110C01011
11011000000100000100000100C0C1
10C101110000010011000000100C01
100011110000101000E01010000001
1110000CC001011C00C111111001C1
10100001100110000000101C000001
10001110C1000C100100C011000001
100001100100100C11000010000001
11010000C00C1C0100C00101000C01
111111111111111111111111111111
