11111111111111111111111111111111111111111111111111111111111111111111111111111111
1110000010011000110C1010100000100110100111C000C00000C00C0010000C0000C00111000111
1101000111100101011C10000100100011C1100101000C1000000010110000100101010CC0010101
1111C001CC010C0011000011000001011C0C0100000C010C000C0101000001C00C0C01000101P101
1000010110000000010101C0110000CC0101010000100CC00010000110000CC00000010101100001
100000C010010001100001010010100110C0101010011000C000010001101001000C000000110011
1C100CC0000C0011000111000000C10C1000010C11010C1C001C1001010011010101C001010000C1
11100001C011100110000100001C000100C0000C00CC000000101111000CC0110101000010C01001
10011011110C00101010011000C01100C000110100C0000C0101010100110000C1C000010011C001
100011000C00000C10C00011101110C001000C0100010C00C00CC11101C011000011000110010011
101010C000C0001000001C00100001101000010010011010000000100001010000C10000C10100C1
10001000010100010C000001CC0000C1000000100110E1C00000110101001110000C0C0111001011
1C0001011000C11001C000100110110000100C00001011110001000010000C100010100000001001
10000C110010111000C1010101000C0000C10C01001110001C000000000010000100100000000001
1111C00C001110C10C001000010000010C0C00000000101C000C100110C010010CC110101C010101
100110100C000000100001000C0C0C100010100001011CC11C11010CCC00100100010110CC001CC1
11C01000C101C11111100100100000110010101010C00011010000100000010101C0000001100011
11010C0000101010001011110C0C0001C100001010010011000C01000CC0000100011011000010C1
1C000010000C00010C100110101C10C0C0C0C1000000C110000100000C0000C000C0001010000001
1000000C10C00000C100C1000000CC000111101CCC1110000100000C001001C01000C10010011011
100101000000010010010100110011101000C0101101100010110010000110000010111010000101
1CC1101000100CC101010000C01C110100100000001000001100CC000000C1101001CC11000010C1
1100100001100100001C01C00001011001000000000C000001011001C1000110CC1C0010000001C1
101000000000C11010C100000C0111000010C100C010C100010101010010000C000101000000C011
11111111111111111111111111111111111111111111111111111111111111111111111111111111